wwwwwwwwwwwwwwwwwwwwwww
wwwwwwwwwwwwwwwwwwwwwww
w.p...o..o...o....o...w
w.w.w.wow.wow.w.w.w.w.w
wo..o..o...o....o.....w
w.w.w.w.w.w.w.w.w.w.w.w
w....o.....o......o...w
w.w.w.w.w.w.w.w.w.w.w.w
w..o...o....o....o....w
w.w.w.wow.w.w.w.wow.w.w
w..o...o..e...o..o....w
w.w.w.w.w.wow.w.w.w.w.w
w....o...o...o...o....w
w.w.w.w.w.w.w.wow.w.w.w
w...o....ooo.....o....w
w.w.w.w.w.w.wow.w.w.w.w
w.....o....o.o..ox....w
wwwwwwwwwwwwwwwwwwwwwww