wwwwwwwwwwwwwwwwwwwwwww
w.....................w
w.....................w
w.....................w
w.....................w
w..........p..........w
w.....................w
w.....................w
wooowo............oooow
w.........e...........w
w.....................w
w.....................w
w.....................w
w........www..........w
w.....................w
w.....................w
w................x....w
wwwwwwwwwwwwwwwwwwwwwww