wwwwwwwwwwwwwwwwwwwwwww
wwwwwwwwwwwwwwwwwwwwwww
wp..o....o...o.....o..w
w.w.wow.w.wow.w.w.w.w.w
w....o...o....o....o..w
w.w.wow.w.w.wow.w.wow.w
w...o..o...o.....o....w
w.wowow.w.w.w.wow.w.w.w
w.o.....o...o....o.e..w
wow.w.w.w.w.w.wow.w.w.w
w.o..o..o.e....o...o..w
w.w.w.wow.w.w.w.w.w.w.w
w....o..o.o....o...o..w
w.w.wxw.w.w.w.w.w.wow.w
w....o..o...o....o....w
w.w.w.wow.w.w.w.w.w.w.w
w..o...o..e.o....o....w
wwwwwwwwwwwwwwwwwwwwwww