wwwwwwwwwwwwwwwwwwwwwww
w.....................w
w.....................w
w.....................w
w.....................w
w..........p..........w
w.....................w
w.....................w
wooowooooooooooooooooow
w.........e...........w
w.....................w
w.....................w
w.....................w
w........www..........w
w.....................w
w.....................w
w.....................w
wwwwwwwwwwwwwwwwwwwwwww