wwwwwwwwwwwwwwwwwwwwwww
w.....................w
w.....................w
w..............o......w
w...o.................w
w..........p..........w
w......o...........o..w
w.....................w
wooowooooooooooooooooow
w.........e...........w
w................e....w
w.....................w
w.....................w
w........www..........w
w....e...........e....w
w.....................w
w..........x..........w
wwwwwwwwwwwwwwwwwwwwwww