wwwwwwwwwwwwwwwwwwwwwww
wwwwwwwwwwwwwwwwwwwwwww
wp....o....o..e..o....w
wowow.w.w.wow.w.wow.wow
w.o.ooo....o....oo.o..w
w.w.w.w.w.w.w.wow.w.w.w
w..o...o....o....o....w
w.w.w.w.w.w.w.w.oow.w.w
w.o..o..o..e.o.....o..w
w.w.w.w.w.w.w.w.wowow.w
w.o..o.e..o.....o...o.w
w.w.w.w.w.w.w.wow.w.w.w
w....o..o..o..o...o...w
w.w.w.wow.w.w.w.w.w.w.w
wo..e....o.o.o...o....w
w.w.wxw.w.w.w.w.w.w.w.w
w..o...o....o..e.o....w
wwwwwwwwwwwwwwwwwwwwwww