wwwwwwwwwwwwwwwwwwwwwww
w.o...........o.......w
w..o.........o.o......w
w...o.......o..oo.....w
w...oo.....o.....o....w
w.....o...op......o...w
w......o.o.........o..w
w.......o...........o.w
wooowooooooooooooooooow
w.........e...........w
w................e....w
w.....................w
w.....................w
w........wwwo.........w
w....e....oooo...e....w
w.........ooo.........w
w.........oxo.........w
wwwwwwwwwwwwwwwwwwwwwww