wwwwwwwwwwwwwwwwwwwwwww
wwwwwwwwwwwwwwwwwwwwwww
wp..o.o....o..e..o....w
w.wowow.w.wow.w.wow.wow
woo.e....o.o.o.o.o....w
w.w.w.w.w.w.w.wowxw.w.w
w.o..o.e..o.....o...o.w
w.w.w.w.w.w.w.wowow.w.w
w.o..o..oo.e.o.o.e.o..w
w.w.w.w.w.w.w.w.wowow.w
w..o.o.o.o..o....o....w
w.w.w.w.wow.w.wow.w.w.w
w.o..o..o..o..o...o...w
w.w.w.wowow.w.wow.w.w.w
w.o.ooo..o.o....oo.o..w
w.w.w.w.w.w.w.w.w.w.w.w
w..o...o.e..o..e.o....w
wwwwwwwwwwwwwwwwwwwwwww