wwwwwwwwwwwwwwwwwwwwwww
w.o...........o.......w
w..o.........o.o......w
w...o.......o..oo.....w
w...oo.....o.....o....w
w.....o...op......o...w
w......oeo.........o..w
we......o..........eoew
wooowooooooooooooooooow
w.........e...........w
w....o.o.o.o.o.o.e.o..w
w....ooeoooooooooooo..w
w.....................w
w........wwwo.........w
w....e....oooo...e....w
w.........ooo.........w
w.........oxo.........w
wwwwwwwwwwwwwwwwwwwwwww