wwwwwwwwwwwwwwwwwwwwwww
wwwwwwwwwwwwwwwwwwwwww
wp....o....o..o..o....w
w.wow.w.w.w.w.w.w.w.w.w
w...e.o..o.o.o.o.o....w
wowowow.w.w.w.w.w.w.w.w
w.o..o.e..o..o..o...o.w
w.w.w.w.w.w.w.w.w.w.w.w
w.o..oo.oo.e.o.o.e.o..w
w.w.wow.w.wowow.w.w.w.w
w..o.o.o.o.xo..o.o....w
w.w.w.w.w.wow.w.w.w.w.w
w.o..o.ooe.o..o...o.e.w
w.w.w.w.w.w.w.w.w.w.w.w
w.o.o....o.o....oooo..w
w.w.w.w.w.w.w.w.w.wowow
w..o.e.o....o..eo...eow
wwwwwwwwwwwwwwwwwwwwwww