wwwwwwwwwwwwwwwwwwwwwww
w..pw.................w
w...w.................w
w..ew.................w
w...w.................w
w.....................w
w.....................w
w.....................w
wooow.................w
w.....................w
w.....................w
w.....................w
w.....................w
w........www..........w
w.....................w
w.....................w
w.....................w
wwwwwwwwwwwwwwwwwwwwwww